//MAP CONVERTED BY dmm2tgm.py THIS HEADER COMMENT PREVENTS RECONVERSION, DO NOT REMOVE
"c" = (
/obj/structure/table/reinforced,
/obj/item/kitchen/knife/combat,
/obj/item/kitchen/knife/combat,
/obj/item/kitchen/knife/combat,
/obj/item/grenade/clusterbuster,
/obj/item/grenade/chem_grenade/incendiary,
/turf/open/floor/circuit/red,
/area/space)
"g" = (
/obj/structure/closet/secure_closet/gamma/sniper,
/turf/open/floor/circuit/red,
/area/space)
"j" = (
/obj/structure/closet/secure_closet/gamma/rocket,
/turf/open/floor/circuit/red,
/area/space)
"l" = (
/turf/closed/wall/mineral/titanium,
/area/space)
"n" = (
/obj/structure/sign/warning/securearea,
/turf/closed/wall/mineral/titanium,
/area/space)
"s" = (
/obj/structure/closet/secure_closet/gamma/pistol,
/turf/open/floor/circuit/red,
/area/space)
"A" = (
/obj/machinery/door/airlock/hatch/gamma,
/turf/open/floor/mineral/plastitanium/red,
/area/space)
"C" = (
/obj/structure/cable{
	icon_state = "0-8"
	},
/obj/machinery/computer/mech_bay_power_console,
/turf/open/floor/circuit/red,
/area/space)
"F" = (
/obj/machinery/power/apc{
	pixel_y = -24
	},
/obj/structure/cable{
	icon_state = "0-4"
	},
/turf/open/floor/mineral/plastitanium/red,
/area/space)
"G" = (
/obj/structure/cable{
	icon_state = "4-8"
	},
/obj/mecha/combat/durand,
/turf/open/floor/mech_bay_recharge_floor,
/area/space)
"P" = (
/turf/open/floor/mineral/plastitanium/red,
/area/space)
"T" = (
/obj/structure/closet/secure_closet/gamma/shotgun,
/turf/open/floor/circuit/red,
/area/space)
"Y" = (
/obj/structure/cable{
	icon_state = "4-8"
	},
/obj/structure/cable{
	icon_state = "0-8"
	},
/obj/machinery/mech_bay_recharge_port,
/turf/open/floor/circuit/red,
/area/space)
"Z" = (
/obj/structure/closet/secure_closet/gamma/energy,
/turf/open/floor/circuit/red,
/area/space)

(1,1,1) = {"
l
l
l
l
l
n
l
"}
(2,1,1) = {"
l
T
P
P
P
F
l
"}
(3,1,1) = {"
l
s
P
j
P
Y
l
"}
(4,1,1) = {"
l
Z
P
c
P
G
l
"}
(5,1,1) = {"
l
g
P
P
P
C
l
"}
(6,1,1) = {"
l
l
l
A
n
l
l
"}
