//MAP CONVERTED BY dmm2tgm.py THIS HEADER COMMENT PREVENTS RECONVERSION, DO NOT REMOVE
"a" = (
/obj/structure/table/reinforced,
/obj/item/kitchen/knife/combat,
/obj/item/kitchen/knife/combat,
/obj/item/kitchen/knife/combat,
/obj/item/grenade/flashbang,
/obj/item/grenade/clusterbuster,
/turf/open/floor/mineral/plastitanium/red,
/area/space)
"e" = (
/obj/structure/closet/secure_closet/gamma/shotgun,
/turf/open/floor/mineral/plastitanium/red,
/area/space)
"j" = (
/obj/structure/closet/secure_closet/gamma/sniper,
/turf/open/floor/mineral/plastitanium/red,
/area/space)
"l" = (
/turf/closed/wall/mineral/titanium,
/area/space)
"n" = (
/obj/structure/sign/warning/securearea,
/turf/closed/wall/mineral/titanium,
/area/space)
"s" = (
/obj/structure/closet/secure_closet/gamma/pistol,
/turf/open/floor/mineral/plastitanium/red,
/area/space)
"x" = (
/obj/structure/cable{
	icon_state = "0-8"
	},
/obj/machinery/computer/mech_bay_power_console,
/turf/open/floor/mineral/plastitanium/red,
/area/space)
"A" = (
/obj/structure/closet/secure_closet/gamma/rocket,
/turf/open/floor/mineral/plastitanium/red,
/area/space)
"F" = (
/obj/machinery/power/apc{
	pixel_y = -24
	},
/obj/structure/cable{
	icon_state = "0-4"
	},
/turf/open/floor/mineral/plastitanium/red,
/area/space)
"G" = (
/obj/structure/cable{
	icon_state = "4-8"
	},
/obj/mecha/combat/durand,
/turf/open/floor/mech_bay_recharge_floor,
/area/space)
"N" = (
/obj/structure/cable{
	icon_state = "4-8"
	},
/obj/structure/cable{
	icon_state = "0-8"
	},
/obj/machinery/mech_bay_recharge_port,
/turf/open/floor/mineral/plastitanium/red,
/area/space)
"P" = (
/turf/open/floor/mineral/plastitanium/red,
/area/space)
"X" = (
/obj/structure/closet/secure_closet/gamma/energy,
/turf/open/floor/mineral/plastitanium/red,
/area/space)

(1,1,1) = {"
l
l
l
l
l
n
l
"}
(2,1,1) = {"
l
e
P
P
P
F
l
"}
(3,1,1) = {"
l
s
P
A
P
N
l
"}
(4,1,1) = {"
l
X
P
a
P
G
l
"}
(5,1,1) = {"
l
j
P
P
P
x
l
"}
(6,1,1) = {"
l
l
l
l
n
l
l
"}
