//MAP CONVERTED BY dmm2tgm.py THIS HEADER COMMENT PREVENTS RECONVERSION, DO NOT REMOVE
"a" = (
/obj/structure/closet/secure_closet/gamma/sniper,
/turf/open/floor/circuit/red,
/area/space)
"d" = (
/obj/structure/closet/secure_closet/gamma/energy,
/turf/open/floor/circuit/red,
/area/space)
"h" = (
/obj/structure/closet/secure_closet/gamma/rocket,
/turf/open/floor/circuit/red,
/area/space)
"i" = (
/obj/structure/cable{
	icon_state = "0-8"
	},
/obj/machinery/computer/mech_bay_power_console,
/turf/open/floor/circuit/red,
/area/space)
"k" = (
/obj/structure/closet/secure_closet/gamma/pistol,
/turf/open/floor/circuit/red,
/area/space)
"l" = (
/turf/closed/wall/mineral/titanium,
/area/space)
"n" = (
/obj/structure/sign/warning/securearea,
/turf/closed/wall/mineral/titanium,
/area/space)
"o" = (
/obj/structure/cable{
	icon_state = "4-8"
	},
/obj/structure/cable{
	icon_state = "0-8"
	},
/obj/machinery/mech_bay_recharge_port,
/turf/open/floor/circuit/red,
/area/space)
"w" = (
/obj/structure/table/reinforced,
/obj/item/kitchen/knife/combat,
/obj/item/kitchen/knife/combat,
/obj/item/kitchen/knife/combat,
/obj/item/grenade/flashbang,
/obj/item/grenade/clusterbuster,
/turf/open/floor/circuit/red,
/area/space)
"F" = (
/obj/machinery/power/apc{
	pixel_y = -24
	},
/obj/structure/cable{
	icon_state = "0-4"
	},
/turf/open/floor/mineral/plastitanium/red,
/area/space)
"G" = (
/obj/structure/cable{
	icon_state = "4-8"
	},
/obj/mecha/combat/durand,
/turf/open/floor/mech_bay_recharge_floor,
/area/space)
"P" = (
/turf/open/floor/mineral/plastitanium/red,
/area/space)
"Q" = (
/obj/structure/closet/secure_closet/gamma/shotgun,
/turf/open/floor/circuit/red,
/area/space)
"R" = (
/obj/machinery/door/airlock/vault/gamma,
/turf/open/floor/mineral/plastitanium/red,
/area/space)

(1,1,1) = {"
l
l
l
l
l
n
l
"}
(2,1,1) = {"
l
Q
P
P
P
F
l
"}
(3,1,1) = {"
l
k
P
h
P
o
l
"}
(4,1,1) = {"
l
d
P
w
P
G
l
"}
(5,1,1) = {"
l
a
P
P
P
i
l
"}
(6,1,1) = {"
l
l
l
R
n
l
l
"}
